-----------------------------------------------------------------------
          -     -       -           -   -       -       -     -     - -
- - - - ----- ----- ----- ----- --- --- - - ----- ----- ----- - - - - -
- - - -   -     -     - -     - -   -   - - -     -       -     - -   -
----- --- --- - - --- - ------- ----- --- ----- ----- ----- ----- --- -
-       - -   -   -         -   -               -       -   -     -   -
- ----- ----- - --------- ----- --- - --- - ----- --- - ------------- -
- - - -   -   -       -   -     - - -   - -     - -   -     -     -   -
- - - --- --- - ----- ----- ----- ----- ----------------- - ----- - ---
-   -   - -   - -   -   -           -     - -     - -     - -   - -   -
- - - --- ------- --- ------- - --- --- - - - - - - ----------- - --- -
- - -   - - -   - - -       - - -     - - -   - - -       -     -   - -
----- --- - - - - - ----- ----- --- - - - - ------- --- --- --- --- - -
-     -   -   -         -     -   - - - -           - - - - -   -     -
- - ----- - - ----- --- - - --- - - ----- - - ----- - --- --- - - --- -
- -     -   -   - - -   - -     - -       - - - -         -   - - -   -
- - --- --- --- - - --- - ----------- --- ----- --- ----- - --- - -----
- -   -     -   - - - -   -         -   -   -         - -   -         -
--- - --- ------- - - - - - --- --------- --- - ------- --- - ----- - -
-   -   - - -       -   -   -     - - -   -   - - - - - - - -   - - - -
--- - --- - - --------- --- ----- - - - ------- - - - - - --- - - -----
-   - -   -       -     -   -     -     -                   - -        
----------------------------------------------------------------------- 